12 60
#######     #############################    ###############
#                  #                 *                     #
#                  #                 *                     #
#                  #                 ****************      #
#                  #                                       #
########   #########                                       #
#                                    *                     #
#                                    *                     #
#                  #                 *                     #
#                  #                 *                     #
#                  #                 *                     #
#######     #############################    ###############