20 50
#################################################
#                #                              #
#                #                              #
#                #                              #
#                #                              #
#                #                              #
#                      ***                      #
#                      ***                      #
##########                     **               # 
#                              **               #
                                                 
                                                 
                                                 
#################    ##########  ############   #
#                                               #
#                                               #
#                                               #
#                       O                       #
#                                               #
#################################################
